Nadipinchu Naa Naavaa – Nadi Sandramuna Devaa
Nava Jeevana Maargamuna – Naa Janma Thariyimpa /Nadipinchu/
[===]
Naa Jeevitha Theeramuna – Naa Apajaya Bhaaramuna
Naligina Naa Hrudayamunu – Nadipinchumu Lothunaku
[===]
Naa Yaathma Virabooya – Naa Deeksha Phaliyimpa
Naa Naavalo Kaalidumu – Naa Seva Chekonumu /Nadipinchu/
[===]
Raathranthayu Shramapadinaa – Raaledu Prabhu Jayamu
Rahadaarulu Vedakinanoo – Raadaayenu Prathiphalamu
[===]
Rakshinchu Nee Siluva – Ramaneeya Lothulalo
Rathanaalanu Vedakutalo – Raajillu Naa Padava /Nadipinchu/
[===]
Aathmarpana Cheyakaye – Aashinchiti Nee Chelimi
Ahamunu Preminchuchune – Arasithi Prabhu Neekalimi
[===]
Aasha Nirashaye – Aavedha Nedhuraye
Aadhyathmika Lemigani – Allade Naa Valalu/Nadipinchu/
[===]
Prabhu Maargamu Vidachithini – Prardhinchuta Maanithini
Parbhu Vaakyamu Vadhalithini – Paramardhamu Marachithini
[===]
Prapancha Natanalalo – Praveenyamunu Pondhi
Phala Heenudanai Ipudu – Paatinthu Nee Maata/Nadipinchu/
[===]
Lothaina Jalamulalo – Lothuna Vinabadu Swaramaa
Lobadutanu Nerpinchi – Lopambulu Savarinchi
[===]
Lonunna Eevulalo – Lothaina Naa Brathuku
Lopinchani Arpanagaa – Lokesha Cheyumayaa /Nadipinchu/
[===]
Prabhu Yesuni Shishyudanai – Prabhu Premalo Paadukoni
Prakatinthunu Lokamulo – Parishudhdhuni Prema Katha
[===]
Paramaathma Prokshanatho – Paripoorna Samarpanatho
Praanambunu Prabhu Koraku – Praanaarpanamu Chethu/Nadipinchu/